15-0X
--0--0----
-----0----
--0----0--
-0-------0
---0----0-
----------
---0------
0--0--00--
----------
---0------
--0-00-0--
----------
---0------
---00-0---
---0-----0
