10.ox
..........
..o.......
..........
...o.....o
..........
..................
..........
...oo.....
.........o
..........
