10.ox
.........o
..O..o..o.
..........
..........
..........
..........
..........
..........
.....o....
..........
