15-oX
-o--o-o---o----
o------oo------
-o-----------oo
---------------
---o-oooo--oo--
-oo--oo-o------
---o--o---oo---
------oo----o-o
------------o--
-------------o-
--------o-o----
-----o-----oo--
----o-----o--o-
---o-o-----o-o-
--------o---o--
