   +00030-oX
--ooo----------o-o-------o-o--------o---o-------o-
----o---o---------o----o-oo------oo--o--o----o----
-o-------oo----------ooo---o---------o-o-o----o-oo
--oo--o---o-----------------o-o-----o---o-----o---
--o-o----------o---------o--o---o---o--o----o-o---
----oo------------o---ooo------------o----oo--o---
--o-oo----------o--o--------o------o-----------o--
----------o---------o-o-------------oo--o---oo----
--o-o--oo-------o---o-----------------o------o-o--
----o----o--o-o-----o--o-o-oo-------o---o----o----
---o--o----o----o---------oo------o-----------o-o-
----------------------oo----o---o------o--o-------
-----------o---o-o-oo---o--------------o--o-o-----
----------o------o----oo----o---o-----------------
--------o---------------o---------o--o-----o------
o-o------o-----o--o--------o--o-o--------o-------o
----------------o---------o-o--o-o-------o-o------
-oo---o---------o--o---o-o---o-------o-------o----
o-o-----o-o-o-----------o-------o--------oo----o--
-------------o---o-ooo-o-------------------------o
o---------o--o-------o----o-----o----o---o--------
------------------oo-oo-o----------o--o--------o--
-----------o-o--oooooo-o-----------------o-o------
-----o--------------o----------------o--o-o------o
---o---------o--o-----o-o-o------o-o-------oo-----
---o-oo-----oo-o-o---o------o----o-------o--------
-o-o---o-----------o--o---------------oo----o-----
-o--------o---o---------------------o------o-o----
-o------------o-----------------oo----------oooo-o
----o---o------o----------------------------o-----
