+30-oX
o-----o-o------o---o--oo---oo--o--o--o-o-----o---o
o--o-----o--o--o--ooooo-------ooo-----------oo-o--
-------o-o----o-oo------o--oo--o----o--oo--o------
ooo-oo-o--o----------o--------o--oo-----o-----o---
--oo----o-o--o-----------o-----------o-o-o---o----
---------ooo--oo----ooo--------o-o-o----o-o-------
oo-------oo---------------o--o----o---o------o---o
----o-----o--o-ooo-------------o-------oo----oo-o-
---------o-oo-----o-oo--o-oo-o----o-o-oo------o-o-
--oo-o-o--o-o-oo---------oo--oo---------o--o--o---
-----o-----------o--oo---------oo----------o--o---
----o-------oo--------oo-----------o-oo-------o---
---oo-oo----o---o---oo---oooo-o--oo-ooo---------o-
-----------------o-----o---o-------o--o--o---o----
--oo----o-o---o----o-------o---o-o-o------oo-----o
-o---o-o-o-o---oo-o------oo----o-o-o--o--o--------
-o--o-o-----ooo--o-o-oo----oo-o--o---------o-o----
-------o-o---------o-----o----o---oo-----o--oo----
---oo-o-o--o-o-oo-------oo---oo-o--o------------oo
o--o--o--------o--o--oo------------o---oo-o-oo-oo-
-------o--ooo-o----o------o--oo------------o-----o
o---o-o-----oo--o-oo---oo---oo--o-o------o--o---o-
o-o---o-------o---o---------o-o---o----o--------o-
--o-o---o------oo--oo-----------o-----------o-----
--o-o--ooo-----------oo-oo--o--o----o-oo-----o--o-
-o-oo---o-o------o-----------o----o----o-o--o-----
ooo---------o----o-oo----oo------oo-----o--o------
o-o-------oo-o----o-o-------oo-------------ooo----
--ooo-oo---o-o------oo---o-o--o-----------o-o----o
-o-ooo--o---o----o-oo-o-oo---o---o-o-o---o-o------
