30-oX
----o-------o------o--ooo----o-oooo---o-oo-oo-o---
o----------o-o----o-oo--o---o------o-o-----oo--oo-
--------o---oo-o--oo-o---oo--oo-oo-oo------o-ooo-o
-o-o-o---o--oo--oo----o-o--o-o------oo----o---o-oo
--ooo--o----ooo-o-o---o---oo-o-----oo---o---oo-oo-
o--o-o----o--oooooo--o---o---o------o------o-----o
o----o--o-o-o---o------oo--o-oo----------o---ooooo
--o------oo-o-o-----o----o-o-oo-------ooo---------
----o--------ooo---oooo-o-o-ooo-o-oo-----o--------
-oo---oo--o-oooo-oo---------oooo-oooooo--o-o------
-o-o-o--o--o-------o--o-o------oo--------o--o---o-
oo------o-------o-o-o----o--o-o--o-o-------ooo-o--
-------ooooo---o----------o--ooo----o--o-o--o-oo-o
--o--o--o--o----o-o--oo-o-o---oo-ooo------o-oooo-o
-o-----------o--oo-o---o-----o--------------o-o--o
----ooo--o---ooo---o-oo--oo--------------o-o----oo
-oo--o-----o-oo--o-------------o-o-----o--oo-o--o-
o---o-ooo--o---ooo------oo----------oo--o----o--oo
-o--oo-----o---o------o--------o--oo-----o--o---o-
--o-oo------o----o--o------o----ooo-----o--o-o-o--
--o-----o----o--oo-----o--o---o-oooo------o--o-o-o
oo----o-oo--o--oo---o----o---o-o---ooo--oo-o--oo--
-o-oo--------o---o--ooo----o--ooo-o---o-o-------o-
-o--o---o-o--------oo---oo-----oo--o--oo---o-o----
-o-o-o-o--o---ooo-o-o--o--o------o--o-o-o--o----oo
-oo-o-oo-o---o-------o-o-------o-----oo--o-----oo-
oo-o------oo---oo-----o-------------o-o--------o--
--o-o---oo-----o-----------oo-oo-o---o-o-oo-ooo--o
ooo-ooo-oo------oo--o-o------o----o------o------o-
---oo---oo-o-oo--o-o-oo----o-ooo-o------oo-oo-oo--

