10
..........
...o......
....o.....
.o.....o..
..o.......
....o.o...
..........
..........
.........o
....o.....
