A.ox
..........
.o.o..o...
..........
..o.......
..........
..........
...o......
.........o
..........
..........
